111111111111111111111111111111111111111111111111111111111111111111111111111111111
10000000001
10000000001
1000C000001
10011111111
100000P0001
10000000E01
10000000001
11111111111
