11111111111
10000000001
10000000001
1000I000001
10011111111
100000P0001
1M000000001
100000000E1
11111111111